name Scary scary dungeon
win 3
####################
#..................#
#......G.........E.#
#.###..............#
#..E...............#
#.###.......G......#
#..................#
#..................#
#..................#
#...###............#
#...#G#............#
#...#.#............#
#..................#
#.G’........######.#
#...........#EG....#
####################
