name Pro dungeon
win 6
#################
#...#..........G#
#...#...........#
#..G#...........#
#...#...........#
#...#.......G...#
#.###...........#
#...............#
#...............#
#...............#
#...............#
#.....##.##.....#
#.....#...#.....#
#.....#...#.....#
#.....#.E.#.....#
#.....#...#.....#
#.....#...#..G..#
#.....##.##.....#
#...............#
#...............#
#....G..........#
#...............#
#...............#
#G.............G#
#################